Adam Smith - Moral Philosopher & Political Economist
Aesop - Fabulist & Storyteller
Alexis de Tocqueville - Observer of Democracy
Alfred Adler - Founder of Individual Psychology
Aristotle - The Philosopher
Arthur Schopenhauer - Philosopher of Pessimism
Baruch Spinoza - God or Nature
Bertrand Russell - Logician & Analytic Philosopher
Carl Jung - Founder of Analytical Psychology
Charles Darwin - Father of Evolutionary Biology
Charles Sanders Peirce - Founder of Pragmatism & Semiotics
Confucius - Sage of Virtue & Harmony
David Hume - Scottish Enlightenment Empiricist
Edward Gibbon - Historian of Rome's Decline
Emma Goldman - Anarchist & Feminist Revolutionary
Francis Bacon - Father of Empiricism
François de La Rochefoucauld - Master of the Maxim
Friedrich Engels - Revolutionary Socialist
Friedrich Nietzsche - Beyond Good and Evil
G.W.F. Hegel - Absolute Idealist & Dialectician
Galileo - Father of Modern Science
George Berkeley - Immaterialist & Anglican Bishop
Gottfried Wilhelm Leibniz - Philosopher of Optimism
Gustave Le Bon - Psychologist of Crowds
Henri Bergson - Philosopher of Time & Intuition
Henri Poincaré - Universal Mathematician
Herbert Spencer - Evolutionary Philosopher
Immanuel Kant - Architect of Critical Philosophy
Isaac Newton - Father of Classical Physics
J.-M. Kuczynski - Contemporary Analytic Philosopher
James Allen - New Thought Pioneer
Jean-Jacques Rousseau (appears TWICE - one should be removed)
John Dewey - Pragmatist & Educational Reformer
John Locke - Father of Classical Liberalism
John Maynard Keynes - Economist & Philosopher
John Stuart Mill - Utilitarian Philosopher & Logician
Karl Marx - Revolutionary Socialist
Karl Popper - Philosopher of Science
Ludwig von Mises - Austrian School Economist
Martin Luther - Protestant Reformer
Moses Maimonides - Medieval Jewish Philosopher
Niccolò Machiavelli - Political Philosopher
Orison Swett Marden - New Thought Pioneer
Plato - Founder of Western Philosophy
René Descartes - Father of Modern Philosophy
Sigmund Freud - Founder of Psychoanalysis
Thomas Hobbes - Author of Leviathan
Thorstein Veblen - Economist & Social Critic
Vladimir Lenin - Revolutionary
Voltaire - Champion of Reason
Wilhelm Reich - Psychoanalyst
Wilhelm Stekel - Pioneer of Active Psychoanalysis
William James - Pragmatist Psychologist
William Whewell - Philosopher of Science